20 20
-------------------
| |               |
| |     ----------|
| |               |
| |---            |
|                 |
| |               |
| |               |
| |---------      |
| |               |
|                 |
|                 |
|                 |
|                 |
|                 |
|                 |
|                 |
|                 |
|                 |
|-----------------|